8 10
L L T T T M M T T T
L T T T T C C C T T
L L C C T C B T T T
M L T T T C B T T L
T L T T T L C T T B
T T T T T C C T T T
C C T C T B C T T T
B B M M T B C T T C